-1 -1 -1 -1 -1 -1 -1 4 0 3 -1 -1 -1 -1 -1 -1 -1 -1 -1 -1
3 6 6 6 6 6 6 5 0 7 6 6 6 6 6 6 6 6 6 4
3 0 2 0 0 2 1 1 0 1 1 1 0 0 2 2 2 2 2 4
3 0 2 0 0 2 0 0 1 0 0 0 0 0 2 1 1 1 1 4
3 0 1 0 1 2 0 1 2 2 2 2 2 2 2 2 2 2 2 4
3 0 1 0 0 2 0 1 2 2 2 2 1 0 1 0 0 0 0 4
3 0 0 0 0 2 0 0 0 0 0 0 0 0 1 0 0 0 0 4
3 0 1 1 1 2 2 2 2 2 2 2 2 2 2 2 0 0 0 4
3 0 2 2 0 2 2 0 0 0 0 0 0 0 0 2 0 0 0 4
3 0 2 2 0 2 2 0 1 1 0 0 0 0 0 2 2 2 1 4
3 0 2 2 0 0 2 1 0 1 0 1 1 1 1 1 2 2 0 4
3 0 2 2 0 0 0 0 0 0 0 1 1 0 0 0 0 0 0 4
7 6 6 6 6 6 6 6 6 6 6 6 6 6 6 6 6 6 6 5