3 5 5 5 5 5 5 5 5 5 4 * * * * 3 5 5 5 5 5 5 5 5 5 4 * * * *
3 0 1 0 0 0 0 0 c 0 4 * * * * 3 0 0 0 2 0 1 0 0 b 4 * * * *
3 0 1 0 1 0 1 0 1 0 2 2 2 2 2 2 0 0 2 0 0 0 1 0 0 4 * * * *
3 0 0 1 0 0 0 0 0 0 0 0 0 0 0 0 0 1 0 c 0 0 0 1 0 4 * * * *
3 0 1 0 1 0 1 0 1 0 1 0 1 0 1 0 1 0 0 0 0 0 0 0 1 4 * * * *
3 0 0 1 0 0 0 0 0 0 0 0 0 0 0 0 0 1 0 0 0 0 0 1 0 4 * * * *
3 0 1 0 1 0 1 0 1 0 2 2 2 2 2 2 0 0 2 0 0 0 1 0 0 4 * * * *
3 0 0 1 0 0 0 0 0 0 4 * * * * 3 0 0 0 2 0 1 0 0 0 4 * * * *
7 5 5 5 5 5 5 5 5 5 6 * * * * 7 5 5 2 0 0 0 2 5 5 6 * * * *
* * * * * * * * * * * * * * * * * * 2 0 2 0 2 * * * * * * *
* * * * * * * * * * * * * * * * * * 2 0 0 0 2 * * * * * * *
* * * * * * * * * * * * * * * * * * * 2 0 2 * * * * * * * *
* * * * * * * * * * * * * 2 2 2 2 2 2 2 0 2 * * * * * * * *
* * * * * * * * * * * * * 2 0 0 0 0 0 0 0 2 * * * * * * * *
* * * * * * * * * * * * * 2 0 0 2 2 2 2 2 2 * * * * * * * *
* * * * * * * * * * * * * 2 0 0 2 * * * * * * * * * * * * *
* * * 2 2 2 2 2 2 2 2 2 2 2 2 2 2 2 2 2 2 2 2 2 2 2 2 * * *
* * * 2 1 0 1 0 1 0 1 0 1 0 0 0 0 1 0 1 0 1 0 1 0 1 2 * * *
* * * 2 0 1 0 1 0 1 0 1 0 1 1 1 1 0 1 0 1 0 1 0 1 0 2 * * *
* * * 2 1 0 1 0 1 0 1 0 1 0 0 0 0 1 0 1 0 1 0 1 0 1 2 * * *
* * * 2 0 1 0 1 0 1 0 1 0 1 0 0 1 0 1 0 1 0 1 0 1 0 2 * * *
* * * 2 1 0 1 0 1 0 1 0 0 d 0 0 0 0 0 1 0 1 0 1 0 1 2 * * *
* * * 2 0 1 0 1 0 1 0 1 0 0 9 9 0 0 1 0 1 0 1 0 1 0 2 * * *
* * * 2 0 1 0 1 0 1 0 1 0 0 0 0 0 0 1 0 1 0 1 0 1 0 2 * * *
* * * 2 1 0 1 0 1 0 1 0 0 0 0 0 0 0 0 1 0 1 0 1 0 1 2 * * *
* * * 2 0 1 0 1 0 1 0 1 0 1 0 0 1 0 1 0 1 0 1 0 1 0 2 * * *
* * * 2 1 0 1 0 1 0 1 0 1 0 0 0 0 1 0 1 0 1 0 1 0 1 2 * * *
* * * 2 0 1 0 1 0 1 0 1 0 1 1 1 1 0 1 0 1 0 1 0 1 0 2 * * *
* * * 2 1 0 1 0 1 0 1 0 1 0 0 0 0 1 0 1 0 1 0 1 0 1 2 * * *
* * * 2 2 2 2 2 2 2 2 2 2 2 2 2 2 2 2 2 2 2 2 2 2 2 2 * * *